전향카빙 Forward Carving
털리다 chatter ; Edge falling continuously but not falling completely.
터지다 washes out/washout/loses edge grip : the falling of the edge completely
골반 로테이션 pelvis rotation
외경 lean-out = angulation
기울기 inclination
기울이다 : tilt
전경 forward shifted weight : a state of that more weight is placed in the front(nose)
중경 centered weight : a state of near-center weight
후경 backward shifted weight : a state of that more weight is placed in the rear(tail)
후경축 rear leg axis??  : The rear leg axis is state of pelvis over the rear foot, and the R or K-shaped position is called the rear leg axis position.
엣지그립력 edge grip(edge hold) : the force of the edge holding the snow.
날박기(날세우기) edging : 날을 세우거나 해서 날을 설면에 파고들게 하는 것.
초급자 beginner
중급자 intermediate
상급자 advanced
전문가 expert
원심력 centrifugal force
구심력 centripetal force
다져진눈 compact snow(packed snow)
인공눈(제설기눈) artifical snow
범프 convex : 볼록한면 이란 단어로 사면에 형성된 눈더미를 표현할때
상체 로테이션 upper body rotation
업다운 : vertical movement
무게중심 : COM (center of mass)
지지점 : BOS (base of support)
폴라인 : fallline
뒷발차기 flat swing
굽히기 : flexion 
앞발 : front foot
뒷발 : rear foot
급사 : steep slope
완사 : gentle slope
상체리딩 : leading the upper body
동조로테이션 : the sychronous rotation
활강 : riding flat, ride flat down(ride flat down the fall line, you can say ride flat to gain speed)
엣지를 세우다 : increase edging, increase the board angle, edge the board
뉴트럴 구간 : neutral section
손짚기 : hand-gliding, put your hand on the slope
엉빠자세 : protruding hip position 
감자 : ice cube

**Frequently mistranslated Words (Because I used a translator before I modified it)
forward -> future
stuck, be caught -> occurs somthing(pressure, resistance, power of edge grip, weight shifting)
burst -> washes out/ washout
Hilton -> heel side turn
blade -> edge
poll line -> fall line

** Similar words
bias -> lean
stage -> step